###################################################
E.....#####....#####...........8...........K.....##
#..............###....###........................##
#.....##..............###.....####....T.....#######
###################################################
