
####################
#.....  .............#
E..!...............#
#......... .........#
#..................#
#......... .........#
#..................#
#..................#
#... ... ............#
#............... ...#
#...... ...!........#
#...........KT.....#
##### ###############









